---------------------------------------------------------------------------xxxx---------------------
xxxxxxxxxxxxxxx--------------------------------------------------------xxxxx---xxxxxxxxxxxxxxxxxxxxx
SSSSSSSSSSSSSSSSSSSSSSSSSSSSSSSSSSSSSSSSSSSS-SSSSSSSSSSSSSSSSSSSSSSS--xx--x----SSSSSSSSSSSSSSSSSSSSS
--------------------[]----[]-----------------------------------------xx---X----S--------------------
--------------------[]----[]-------E----------------xxx-------------xx------------------------------
--------------------[]----[]---QQQQQQ--------xxxxxxxx--x---xxxxxxxxxx-------------------------------
--------------------<>----[]----------------xxSSSSSSS---x--xSSSSSSSSS-X--------X--------------------
--------------------------[]---------------xx-SSSSSSS----x-xSSSSSSSS--------------------------------
--------------------------[]--xxxxxxxxxxxxxx--SSSSSSS--E--xxSSSSSSS---------------------------------
--------------------------[]-xxSSSSSSSSSSSSS--SSSSSSS-->---?SSSSSS---------------------XXX---------E
-----SS-------------------<>xx-SSSSSSSSSSSSS----------]]------------------------------------------<>
>----SS--------xxx-xxx-----xx--SSSSSSSSSSSSS---------<]]------------------X-----------------------[]
]----SSxxxxxxxxx--xx--xxxxxx---SSSSSSSSSSSSS---------[]]------------------------------------------[]
XXXXXXXXXXXXXXXX--XX--XXXXXXE--XXXXXXXXXXXXXXXXXXXXXXXXXXXXXXXXXXXXX---------------------------XXXXX